XXXXXXX2222XXXXXXX
X              H0X
X                X
X  A2          A3X
X                X
X                X
X    XX   XH1    X
X     X XX       X
X    SXX       A4X
X     X XX H2    X
X    XX   X      X
X                X
X                X
X     B2         X
X  A2          A1X
X              H0X
X                X
XXXXXXX1111XXXXXXX
