4XXXXXXXXXXXXXXXX4
X4X     H1     X4X
XX4X          X4XX
X X4X        X4X X
X  X4X      X4X  X
X   X4XA1A1X4X   X
X    X      X    X
X  B1S      S  H0X
X    A4     A2   X
X    A2     A4   X
X    S      S B2 X
X    X      X    X
X   X4XA3A3X4X   X
X  X4X      X4X  X
X X4X        X4X X
XX4X     H2   X4XX
X4X            X4X
4XXXXXXXXXXXXXXXX4